[
13,13,13,13,13,13,13,13,13,13,
13,9,11,10,8,7,10,11,9,13,
13,12,12,12,12,12,12,12,12,13,
13,0,0,0,0,0,0,0,0,13,
13,0,0,0,0,0,0,0,0,13,
13,0,0,0,0,0,0,0,0,13,
13,0,0,0,0,0,0,0,0,13,
13,6,6,6,6,6,6,6,6,13,
13,3,5,4,2,1,4,5,3,13,
13,13,13,13,13,13,13,13,13,13
]